Bulbasaur	Grass	Poison
Ivysaur	Grass	Poison
Venusaur	Grass	Poison
Venusaur-Mega	Grass	Poison
Venusaur-Gmax	Grass	Poison
Charmander	Fire
Charmeleon	Fire
Charizard	Fire	Flying
Charizard-Mega-X	Fire	Dragon
Charizard-Mega-Y	Fire	Flying
Charizard-Gmax	Fire	Flying
Squirtle	Water
Wartortle	Water
Blastoise	Water
Blastoise-Mega	Water
Blastoise-Gmax	Water
Caterpie	Bug
Metapod	Bug
Butterfree	Bug	Flying
Butterfree-Gmax	Bug	Flying
Weedle	Bug	Poison
Kakuna	Bug	Poison
Beedrill	Bug	Poison
Beedrill-Mega	Bug	Poison
Pidgey	Normal	Flying
Pidgeotto	Normal	Flying
Pidgeot	Normal	Flying
Pidgeot-Mega	Normal	Flying
Rattata	Normal
Rattata-Alola	Dark	Normal
Raticate	Normal
Raticate-Alola	Dark	Normal
Raticate-Alola-Totem	Dark	Normal
Spearow	Normal	Flying
Fearow	Normal	Flying
Ekans	Poison
Arbok	Poison
Pikachu	Electric
Pikachu-Cosplay	Electric
Pikachu-Rock-Star	Electric
Pikachu-Belle	Electric
Pikachu-Pop-Star	Electric
Pikachu-PhD	Electric
Pikachu-Libre	Electric
Pikachu-Original	Electric
Pikachu-Hoenn	Electric
Pikachu-Sinnoh	Electric
Pikachu-Unova	Electric
Pikachu-Kalos	Electric
Pikachu-Alola	Electric
Pikachu-Partner	Electric
Pikachu-Starter	Electric
Pikachu-Gmax	Electric
Pikachu-World	Electric
Raichu	Electric
Raichu-Alola	Electric	Psychic
Sandshrew	Ground
Sandshrew-Alola	Ice	Steel
Sandslash	Ground
Sandslash-Alola	Ice	Steel
Nidoran-F	Poison
Nidorina	Poison
Nidoqueen	Poison	Ground
Nidoran-M	Poison
Nidorino	Poison
Nidoking	Poison	Ground
Clefairy	Fairy
Clefable	Fairy
Vulpix	Fire
Vulpix-Alola	Ice
Ninetales	Fire
Ninetales-Alola	Ice	Fairy
Jigglypuff	Normal	Fairy
Wigglytuff	Normal	Fairy
Zubat	Poison	Flying
Golbat	Poison	Flying
Oddish	Grass	Poison
Gloom	Grass	Poison
Vileplume	Grass	Poison
Paras	Bug	Grass
Parasect	Bug	Grass
Venonat	Bug	Poison
Venomoth	Bug	Poison
Diglett	Ground
Diglett-Alola	Ground	Steel
Dugtrio	Ground
Dugtrio-Alola	Ground	Steel
Meowth	Normal
Meowth-Alola	Dark
Meowth-Galar	Steel
Meowth-Gmax	Normal
Persian	Normal
Persian-Alola	Dark
Psyduck	Water
Golduck	Water
Mankey	Fighting
Primeape	Fighting
Growlithe	Fire
Arcanine	Fire
Poliwag	Water
Poliwhirl	Water
Poliwrath	Water	Fighting
Abra	Psychic
Kadabra	Psychic
Alakazam	Psychic
Alakazam-Mega	Psychic
Machop	Fighting
Machoke	Fighting
Machamp	Fighting
Machamp-Gmax	Fighting
Bellsprout	Grass	Poison
Weepinbell	Grass	Poison
Victreebel	Grass	Poison
Tentacool	Water	Poison
Tentacruel	Water	Poison
Geodude	Rock	Ground
Geodude-Alola	Rock	Electric
Graveler	Rock	Ground
Graveler-Alola	Rock	Electric
Golem	Rock	Ground
Golem-Alola	Rock	Electric
Ponyta	Fire
Ponyta-Galar	Psychic
Rapidash	Fire
Rapidash-Galar	Psychic	Fairy
Slowpoke	Water	Psychic
Slowpoke-Galar	Psychic
Slowbro	Water	Psychic
Slowbro-Mega	Water	Psychic
Slowbro-Galar	Poison	Psychic
Magnemite	Electric	Steel
Magneton	Electric	Steel
Farfetch'd	Normal	Flying
Farfetch'd-Galar	Fighting
Doduo	Normal	Flying
Dodrio	Normal	Flying
Seel	Water
Dewgong	Water	Ice
Grimer	Poison
Grimer-Alola	Poison	Dark
Muk	Poison
Muk-Alola	Poison	Dark
Shellder	Water
Cloyster	Water	Ice
Gastly	Ghost	Poison
Haunter	Ghost	Poison
Gengar	Ghost	Poison
Gengar-Mega	Ghost	Poison
Gengar-Gmax	Ghost	Poison
Onix	Rock	Ground
Drowzee	Psychic
Hypno	Psychic
Krabby	Water
Kingler	Water
Kingler-Gmax	Water
Voltorb	Electric
Electrode	Electric
Exeggcute	Grass	Psychic
Exeggutor	Grass	Psychic
Exeggutor-Alola	Grass	Dragon
Cubone	Ground
Marowak	Ground
Marowak-Alola	Fire	Ghost
Marowak-Alola-Totem	Fire	Ghost
Hitmonlee	Fighting
Hitmonchan	Fighting
Lickitung	Normal
Koffing	Poison
Weezing	Poison
Weezing-Galar	Poison	Fairy
Rhyhorn	Ground	Rock
Rhydon	Ground	Rock
Chansey	Normal
Tangela	Grass
Kangaskhan	Normal
Kangaskhan-Mega	Normal
Horsea	Water
Seadra	Water
Goldeen	Water
Seaking	Water
Staryu	Water
Starmie	Water	Psychic
Mr. Mime	Psychic	Fairy
Mr. Mime-Galar	Ice	Psychic
Scyther	Bug	Flying
Jynx	Ice	Psychic
Electabuzz	Electric
Magmar	Fire
Pinsir	Bug
Pinsir-Mega	Bug	Flying
Tauros	Normal
Magikarp	Water
Gyarados	Water	Flying
Gyarados-Mega	Water	Dark
Lapras	Water	Ice
Lapras-Gmax	Water	Ice
Ditto	Normal
Eevee	Normal
Eevee-Starter	Normal
Eevee-Gmax	Normal
Vaporeon	Water
Jolteon	Electric
Flareon	Fire
Porygon	Normal
Omanyte	Rock	Water
Omastar	Rock	Water
Kabuto	Rock	Water
Kabutops	Rock	Water
Aerodactyl	Rock	Flying
Aerodactyl-Mega	Rock	Flying
Snorlax	Normal
Snorlax-Gmax	Normal
Articuno	Ice	Flying
Zapdos	Electric	Flying
Moltres	Fire	Flying
Dratini	Dragon
Dragonair	Dragon
Dragonite	Dragon	Flying
Mewtwo	Psychic
Mewtwo-Mega-X	Psychic	Fighting
Mewtwo-Mega-Y	Psychic
Mew	Psychic
Chikorita	Grass
Bayleef	Grass
Meganium	Grass
Cyndaquil	Fire
Quilava	Fire
Typhlosion	Fire
Totodile	Water
Croconaw	Water
Feraligatr	Water
Sentret	Normal
Furret	Normal
Hoothoot	Normal	Flying
Noctowl	Normal	Flying
Ledyba	Bug	Flying
Ledian	Bug	Flying
Spinarak	Bug	Poison
Ariados	Bug	Poison
Crobat	Poison	Flying
Chinchou	Water	Electric
Lanturn	Water	Electric
Pichu	Electric
Pichu-Spiky-eared	Electric
Cleffa	Fairy
Igglybuff	Normal	Fairy
Togepi	Fairy
Togetic	Fairy	Flying
Natu	Psychic	Flying
Xatu	Psychic	Flying
Mareep	Electric
Flaaffy	Electric
Ampharos	Electric
Ampharos-Mega	Electric	Dragon
Bellossom	Grass
Marill	Water	Fairy
Azumarill	Water	Fairy
Sudowoodo	Rock
Politoed	Water
Hoppip	Grass	Flying
Skiploom	Grass	Flying
Jumpluff	Grass	Flying
Aipom	Normal
Sunkern	Grass
Sunflora	Grass
Yanma	Bug	Flying
Wooper	Water	Ground
Quagsire	Water	Ground
Espeon	Psychic
Umbreon	Dark
Murkrow	Dark	Flying
Slowking	Water	Psychic
Misdreavus	Ghost
Unown	Psychic
Wobbuffet	Psychic
Girafarig	Normal	Psychic
Pineco	Bug
Forretress	Bug	Steel
Dunsparce	Normal
Gligar	Ground	Flying
Steelix	Steel	Ground
Steelix-Mega	Steel	Ground
Snubbull	Fairy
Granbull	Fairy
Qwilfish	Water	Poison
Scizor	Bug	Steel
Scizor-Mega	Bug	Steel
Shuckle	Bug	Rock
Heracross	Bug	Fighting
Heracross-Mega	Bug	Fighting
Sneasel	Dark	Ice
Teddiursa	Normal
Ursaring	Normal
Slugma	Fire
Magcargo	Fire	Rock
Swinub	Ice	Ground
Piloswine	Ice	Ground
Corsola	Water	Rock
Corsola-Galar	Ghost
Remoraid	Water
Octillery	Water
Delibird	Ice	Flying
Mantine	Water	Flying
Skarmory	Steel	Flying
Houndour	Dark	Fire
Houndoom	Dark	Fire
Houndoom-Mega	Dark	Fire
Kingdra	Water	Dragon
Phanpy	Ground
Donphan	Ground
Porygon2	Normal
Stantler	Normal
Smeargle	Normal
Tyrogue	Fighting
Hitmontop	Fighting
Smoochum	Ice	Psychic
Elekid	Electric
Magby	Fire
Miltank	Normal
Blissey	Normal
Raikou	Electric
Entei	Fire
Suicune	Water
Larvitar	Rock	Ground
Pupitar	Rock	Ground
Tyranitar	Rock	Dark
Tyranitar-Mega	Rock	Dark
Lugia	Psychic	Flying
Ho-Oh	Fire	Flying
Celebi	Psychic	Grass
Treecko	Grass
Grovyle	Grass
Sceptile	Grass
Sceptile-Mega	Grass	Dragon
Torchic	Fire
Combusken	Fire	Fighting
Blaziken	Fire	Fighting
Blaziken-Mega	Fire	Fighting
Mudkip	Water
Marshtomp	Water	Ground
Swampert	Water	Ground
Swampert-Mega	Water	Ground
Poochyena	Dark
Mightyena	Dark
Zigzagoon	Normal
Zigzagoon-Galar	Dark	Normal
Linoone	Normal
Linoone-Galar	Dark	Normal
Wurmple	Bug
Silcoon	Bug
Beautifly	Bug	Flying
Cascoon	Bug
Dustox	Bug	Poison
Lotad	Water	Grass
Lombre	Water	Grass
Ludicolo	Water	Grass
Seedot	Grass
Nuzleaf	Grass	Dark
Shiftry	Grass	Dark
Taillow	Normal	Flying
Swellow	Normal	Flying
Wingull	Water	Flying
Pelipper	Water	Flying
Ralts	Psychic	Fairy
Kirlia	Psychic	Fairy
Gardevoir	Psychic	Fairy
Gardevoir-Mega	Psychic	Fairy
Surskit	Bug	Water
Masquerain	Bug	Flying
Shroomish	Grass
Breloom	Grass	Fighting
Slakoth	Normal
Vigoroth	Normal
Slaking	Normal
Nincada	Bug	Ground
Ninjask	Bug	Flying
Shedinja	Bug	Ghost
Whismur	Normal
Loudred	Normal
Exploud	Normal
Makuhita	Fighting
Hariyama	Fighting
Azurill	Normal	Fairy
Nosepass	Rock
Skitty	Normal
Delcatty	Normal
Sableye	Dark	Ghost
Sableye-Mega	Dark	Ghost
Mawile	Steel	Fairy
Mawile-Mega	Steel	Fairy
Aron	Steel	Rock
Lairon	Steel	Rock
Aggron	Steel	Rock
Aggron-Mega	Steel
Meditite	Fighting	Psychic
Medicham	Fighting	Psychic
Medicham-Mega	Fighting	Psychic
Electrike	Electric
Manectric	Electric
Manectric-Mega	Electric
Plusle	Electric
Minun	Electric
Volbeat	Bug
Illumise	Bug
Roselia	Grass	Poison
Gulpin	Poison
Swalot	Poison
Carvanha	Water	Dark
Sharpedo	Water	Dark
Sharpedo-Mega	Water	Dark
Wailmer	Water
Wailord	Water
Numel	Fire	Ground
Camerupt	Fire	Ground
Camerupt-Mega	Fire	Ground
Torkoal	Fire
Spoink	Psychic
Grumpig	Psychic
Spinda	Normal
Trapinch	Ground
Vibrava	Ground	Dragon
Flygon	Ground	Dragon
Cacnea	Grass
Cacturne	Grass	Dark
Swablu	Normal	Flying
Altaria	Dragon	Flying
Altaria-Mega	Dragon	Fairy
Zangoose	Normal
Seviper	Poison
Lunatone	Rock	Psychic
Solrock	Rock	Psychic
Barboach	Water	Ground
Whiscash	Water	Ground
Corphish	Water
Crawdaunt	Water	Dark
Baltoy	Ground	Psychic
Claydol	Ground	Psychic
Lileep	Rock	Grass
Cradily	Rock	Grass
Anorith	Rock	Bug
Armaldo	Rock	Bug
Feebas	Water
Milotic	Water
Castform	Normal
Castform-Sunny	Fire
Castform-Rainy	Water
Castform-Snowy	Ice
Kecleon	Normal
Shuppet	Ghost
Banette	Ghost
Banette-Mega	Ghost
Duskull	Ghost
Dusclops	Ghost
Tropius	Grass	Flying
Chimecho	Psychic
Absol	Dark
Absol-Mega	Dark
Wynaut	Psychic
Snorunt	Ice
Glalie	Ice
Glalie-Mega	Ice
Spheal	Ice	Water
Sealeo	Ice	Water
Walrein	Ice	Water
Clamperl	Water
Huntail	Water
Gorebyss	Water
Relicanth	Water	Rock
Luvdisc	Water
Bagon	Dragon
Shelgon	Dragon
Salamence	Dragon	Flying
Salamence-Mega	Dragon	Flying
Beldum	Steel	Psychic
Metang	Steel	Psychic
Metagross	Steel	Psychic
Metagross-Mega	Steel	Psychic
Regirock	Rock
Regice	Ice
Registeel	Steel
Latias	Dragon	Psychic
Latias-Mega	Dragon	Psychic
Latios	Dragon	Psychic
Latios-Mega	Dragon	Psychic
Kyogre	Water
Kyogre-Primal	Water
Groudon	Ground
Groudon-Primal	Ground	Fire
Rayquaza	Dragon	Flying
Rayquaza-Mega	Dragon	Flying
Jirachi	Steel	Psychic
Deoxys	Psychic
Deoxys-Attack	Psychic
Deoxys-Defense	Psychic
Deoxys-Speed	Psychic
Turtwig	Grass
Grotle	Grass
Torterra	Grass	Ground
Chimchar	Fire
Monferno	Fire	Fighting
Infernape	Fire	Fighting
Piplup	Water
Prinplup	Water
Empoleon	Water	Steel
Starly	Normal	Flying
Staravia	Normal	Flying
Staraptor	Normal	Flying
Bidoof	Normal
Bibarel	Normal	Water
Kricketot	Bug
Kricketune	Bug
Shinx	Electric
Luxio	Electric
Luxray	Electric
Budew	Grass	Poison
Roserade	Grass	Poison
Cranidos	Rock
Rampardos	Rock
Shieldon	Rock	Steel
Bastiodon	Rock	Steel
Burmy	Bug
Wormadam	Bug	Grass
Wormadam-Sandy	Bug	Ground
Wormadam-Trash	Bug	Steel
Mothim	Bug	Flying
Combee	Bug	Flying
Vespiquen	Bug	Flying
Pachirisu	Electric
Buizel	Water
Floatzel	Water
Cherubi	Grass
Cherrim	Grass
Cherrim-Sunshine	Grass
Shellos	Water
Gastrodon	Water	Ground
Ambipom	Normal
Drifloon	Ghost	Flying
Drifblim	Ghost	Flying
Buneary	Normal
Lopunny	Normal
Lopunny-Mega	Normal	Fighting
Mismagius	Ghost
Honchkrow	Dark	Flying
Glameow	Normal
Purugly	Normal
Chingling	Psychic
Stunky	Poison	Dark
Skuntank	Poison	Dark
Bronzor	Steel	Psychic
Bronzong	Steel	Psychic
Bonsly	Rock
Mime Jr.	Psychic	Fairy
Happiny	Normal
Chatot	Normal	Flying
Spiritomb	Ghost	Dark
Gible	Dragon	Ground
Gabite	Dragon	Ground
Garchomp	Dragon	Ground
Garchomp-Mega	Dragon	Ground
Munchlax	Normal
Riolu	Fighting
Lucario	Fighting	Steel
Lucario-Mega	Fighting	Steel
Hippopotas	Ground
Hippowdon	Ground
Skorupi	Poison	Bug
Drapion	Poison	Dark
Croagunk	Poison	Fighting
Toxicroak	Poison	Fighting
Carnivine	Grass
Finneon	Water
Lumineon	Water
Mantyke	Water	Flying
Snover	Grass	Ice
Abomasnow	Grass	Ice
Abomasnow-Mega	Grass	Ice
Weavile	Dark	Ice
Magnezone	Electric	Steel
Lickilicky	Normal
Rhyperior	Ground	Rock
Tangrowth	Grass
Electivire	Electric
Magmortar	Fire
Togekiss	Fairy	Flying
Yanmega	Bug	Flying
Leafeon	Grass
Glaceon	Ice
Gliscor	Ground	Flying
Mamoswine	Ice	Ground
Porygon-Z	Normal
Gallade	Psychic	Fighting
Gallade-Mega	Psychic	Fighting
Probopass	Rock	Steel
Dusknoir	Ghost
Froslass	Ice	Ghost
Rotom	Electric	Ghost
Rotom-Heat	Electric	Fire
Rotom-Wash	Electric	Water
Rotom-Frost	Electric	Ice
Rotom-Fan	Electric	Flying
Rotom-Mow	Electric	Grass
Uxie	Psychic
Mesprit	Psychic
Azelf	Psychic
Dialga	Steel	Dragon
Palkia	Water	Dragon
Heatran	Fire	Steel
Regigigas	Normal
Giratina	Ghost	Dragon
Giratina-Origin	Ghost	Dragon
Cresselia	Psychic
Phione	Water
Manaphy	Water
Darkrai	Dark
Shaymin	Grass
Shaymin-Sky	Grass	Flying
Arceus	Normal
Arceus-Bug	Bug
Arceus-Dark	Dark
Arceus-Dragon	Dragon
Arceus-Electric	Electric
Arceus-Fairy	Fairy
Arceus-Fighting	Fighting
Arceus-Fire	Fire
Arceus-Flying	Flying
Arceus-Ghost	Ghost
Arceus-Grass	Grass
Arceus-Ground	Ground
Arceus-Ice	Ice
Arceus-Poison	Poison
Arceus-Psychic	Psychic
Arceus-Rock	Rock
Arceus-Steel	Steel
Arceus-Water	Water
Victini	Psychic	Fire
Snivy	Grass
Servine	Grass
Serperior	Grass
Tepig	Fire
Pignite	Fire	Fighting
Emboar	Fire	Fighting
Oshawott	Water
Dewott	Water
Samurott	Water
Patrat	Normal
Watchog	Normal
Lillipup	Normal
Herdier	Normal
Stoutland	Normal
Purrloin	Dark
Liepard	Dark
Pansage	Grass
Simisage	Grass
Pansear	Fire
Simisear	Fire
Panpour	Water
Simipour	Water
Munna	Psychic
Musharna	Psychic
Pidove	Normal	Flying
Tranquill	Normal	Flying
Unfezant	Normal	Flying
Blitzle	Electric
Zebstrika	Electric
Roggenrola	Rock
Boldore	Rock
Gigalith	Rock
Woobat	Psychic	Flying
Swoobat	Psychic	Flying
Drilbur	Ground
Excadrill	Ground	Steel
Audino	Normal
Audino-Mega	Normal	Fairy
Timburr	Fighting
Gurdurr	Fighting
Conkeldurr	Fighting
Tympole	Water
Palpitoad	Water	Ground
Seismitoad	Water	Ground
Throh	Fighting
Sawk	Fighting
Sewaddle	Bug	Grass
Swadloon	Bug	Grass
Leavanny	Bug	Grass
Venipede	Bug	Poison
Whirlipede	Bug	Poison
Scolipede	Bug	Poison
Cottonee	Grass	Fairy
Whimsicott	Grass	Fairy
Petilil	Grass
Lilligant	Grass
Basculin	Water
Basculin-Blue-Striped	Water
Sandile	Ground	Dark
Krokorok	Ground	Dark
Krookodile	Ground	Dark
Darumaka	Fire
Darumaka-Galar	Ice
Darmanitan	Fire
Darmanitan-Zen	Fire	Psychic
Darmanitan-Galar	Ice
Darmanitan-Galar-Zen	Ice	Fire
Maractus	Grass
Dwebble	Bug	Rock
Crustle	Bug	Rock
Scraggy	Dark	Fighting
Scrafty	Dark	Fighting
Sigilyph	Psychic	Flying
Yamask	Ghost
Yamask-Galar	Ground	Ghost
Cofagrigus	Ghost
Tirtouga	Water	Rock
Carracosta	Water	Rock
Archen	Rock	Flying
Archeops	Rock	Flying
Trubbish	Poison
Garbodor	Poison
Garbodor-Gmax	Poison
Zorua	Dark
Zoroark	Dark
Minccino	Normal
Cinccino	Normal
Gothita	Psychic
Gothorita	Psychic
Gothitelle	Psychic
Solosis	Psychic
Duosion	Psychic
Reuniclus	Psychic
Ducklett	Water	Flying
Swanna	Water	Flying
Vanillite	Ice
Vanillish	Ice
Vanilluxe	Ice
Deerling	Normal	Grass
Sawsbuck	Normal	Grass
Emolga	Electric	Flying
Karrablast	Bug
Escavalier	Bug	Steel
Foongus	Grass	Poison
Amoonguss	Grass	Poison
Frillish	Water	Ghost
Jellicent	Water	Ghost
Alomomola	Water
Joltik	Bug	Electric
Galvantula	Bug	Electric
Ferroseed	Grass	Steel
Ferrothorn	Grass	Steel
Klink	Steel
Klang	Steel
Klinklang	Steel
Tynamo	Electric
Eelektrik	Electric
Eelektross	Electric
Elgyem	Psychic
Beheeyem	Psychic
Litwick	Ghost	Fire
Lampent	Ghost	Fire
Chandelure	Ghost	Fire
Axew	Dragon
Fraxure	Dragon
Haxorus	Dragon
Cubchoo	Ice
Beartic	Ice
Cryogonal	Ice
Shelmet	Bug
Accelgor	Bug
Stunfisk	Ground	Electric
Stunfisk-Galar	Ground	Steel
Mienfoo	Fighting
Mienshao	Fighting
Druddigon	Dragon
Golett	Ground	Ghost
Golurk	Ground	Ghost
Pawniard	Dark	Steel
Bisharp	Dark	Steel
Bouffalant	Normal
Rufflet	Normal	Flying
Braviary	Normal	Flying
Vullaby	Dark	Flying
Mandibuzz	Dark	Flying
Heatmor	Fire
Durant	Bug	Steel
Deino	Dark	Dragon
Zweilous	Dark	Dragon
Hydreigon	Dark	Dragon
Larvesta	Bug	Fire
Volcarona	Bug	Fire
Cobalion	Steel	Fighting
Terrakion	Rock	Fighting
Virizion	Grass	Fighting
Tornadus	Flying
Tornadus-Therian	Flying
Thundurus	Electric	Flying
Thundurus-Therian	Electric	Flying
Reshiram	Dragon	Fire
Zekrom	Dragon	Electric
Landorus	Ground	Flying
Landorus-Therian	Ground	Flying
Kyurem	Dragon	Ice
Kyurem-Black	Dragon	Ice
Kyurem-White	Dragon	Ice
Keldeo	Water	Fighting
Keldeo-Resolute	Water	Fighting
Meloetta	Normal	Psychic
Meloetta-Pirouette	Normal	Fighting
Genesect	Bug	Steel
Genesect-Douse	Bug	Steel
Genesect-Shock	Bug	Steel
Genesect-Burn	Bug	Steel
Genesect-Chill	Bug	Steel
Chespin	Grass
Quilladin	Grass
Chesnaught	Grass	Fighting
Fennekin	Fire
Braixen	Fire
Delphox	Fire	Psychic
Froakie	Water
Frogadier	Water
Greninja	Water	Dark
Greninja-Ash	Water	Dark
Bunnelby	Normal
Diggersby	Normal	Ground
Fletchling	Normal	Flying
Fletchinder	Fire	Flying
Talonflame	Fire	Flying
Scatterbug	Bug
Spewpa	Bug
Vivillon	Bug	Flying
Vivillon-Fancy	Bug	Flying
Vivillon-Pokeball	Bug	Flying
Litleo	Fire	Normal
Pyroar	Fire	Normal
Flabébé	Fairy
Floette	Fairy
Floette-Eternal	Fairy
Florges	Fairy
Skiddo	Grass
Gogoat	Grass
Pancham	Fighting
Pangoro	Fighting	Dark
Furfrou	Normal
Espurr	Psychic
Meowstic	Psychic
Meowstic-F	Psychic
Honedge	Steel	Ghost
Doublade	Steel	Ghost
Aegislash	Steel	Ghost
Aegislash-Blade	Steel	Ghost
Spritzee	Fairy
Aromatisse	Fairy
Swirlix	Fairy
Slurpuff	Fairy
Inkay	Dark	Psychic
Malamar	Dark	Psychic
Binacle	Rock	Water
Barbaracle	Rock	Water
Skrelp	Poison	Water
Dragalge	Poison	Dragon
Clauncher	Water
Clawitzer	Water
Helioptile	Electric	Normal
Heliolisk	Electric	Normal
Tyrunt	Rock	Dragon
Tyrantrum	Rock	Dragon
Amaura	Rock	Ice
Aurorus	Rock	Ice
Sylveon	Fairy
Hawlucha	Fighting	Flying
Dedenne	Electric	Fairy
Carbink	Rock	Fairy
Goomy	Dragon
Sliggoo	Dragon
Goodra	Dragon
Klefki	Steel	Fairy
Phantump	Ghost	Grass
Trevenant	Ghost	Grass
Pumpkaboo	Ghost	Grass
Pumpkaboo-Small	Ghost	Grass
Pumpkaboo-Large	Ghost	Grass
Pumpkaboo-Super	Ghost	Grass
Gourgeist	Ghost	Grass
Gourgeist-Small	Ghost	Grass
Gourgeist-Large	Ghost	Grass
Gourgeist-Super	Ghost	Grass
Bergmite	Ice
Avalugg	Ice
Noibat	Flying	Dragon
Noivern	Flying	Dragon
Xerneas	Fairy
Xerneas-Neutral	Fairy
Yveltal	Dark	Flying
Zygarde	Dragon	Ground
Zygarde-10%	Dragon	Ground
Zygarde-Complete	Dragon	Ground
Diancie	Rock	Fairy
Diancie-Mega	Rock	Fairy
Hoopa	Psychic	Ghost
Hoopa-Unbound	Psychic	Dark
Volcanion	Fire	Water
Rowlet	Grass	Flying
Dartrix	Grass	Flying
Decidueye	Grass	Ghost
Litten	Fire
Torracat	Fire
Incineroar	Fire	Dark
Popplio	Water
Brionne	Water
Primarina	Water	Fairy
Pikipek	Normal	Flying
Trumbeak	Normal	Flying
Toucannon	Normal	Flying
Yungoos	Normal
Gumshoos	Normal
Gumshoos-Totem	Normal
Grubbin	Bug
Charjabug	Bug	Electric
Vikavolt	Bug	Electric
Vikavolt-Totem	Bug	Electric
Crabrawler	Fighting
Crabominable	Fighting	Ice
Oricorio	Fire	Flying
Oricorio-Pom-Pom	Electric	Flying
Oricorio-Pa'u	Psychic	Flying
Oricorio-Sensu	Ghost	Flying
Cutiefly	Bug	Fairy
Ribombee	Bug	Fairy
Ribombee-Totem	Bug	Fairy
Rockruff	Rock
Lycanroc	Rock
Lycanroc-Midnight	Rock
Lycanroc-Dusk	Rock
Wishiwashi	Water
Wishiwashi-School	Water
Mareanie	Poison	Water
Toxapex	Poison	Water
Mudbray	Ground
Mudsdale	Ground
Dewpider	Water	Bug
Araquanid	Water	Bug
Araquanid-Totem	Water	Bug
Fomantis	Grass
Lurantis	Grass
Lurantis-Totem	Grass
Morelull	Grass	Fairy
Shiinotic	Grass	Fairy
Salandit	Poison	Fire
Salazzle	Poison	Fire
Salazzle-Totem	Poison	Fire
Stufful	Normal	Fighting
Bewear	Normal	Fighting
Bounsweet	Grass
Steenee	Grass
Tsareena	Grass
Comfey	Fairy
Oranguru	Normal	Psychic
Passimian	Fighting
Wimpod	Bug	Water
Golisopod	Bug	Water
Sandygast	Ghost	Ground
Palossand	Ghost	Ground
Pyukumuku	Water
Type: Null	Normal
Silvally	Normal
Silvally-Bug	Bug
Silvally-Dark	Dark
Silvally-Dragon	Dragon
Silvally-Electric	Electric
Silvally-Fairy	Fairy
Silvally-Fighting	Fighting
Silvally-Fire	Fire
Silvally-Flying	Flying
Silvally-Ghost	Ghost
Silvally-Grass	Grass
Silvally-Ground	Ground
Silvally-Ice	Ice
Silvally-Poison	Poison
Silvally-Psychic	Psychic
Silvally-Rock	Rock
Silvally-Steel	Steel
Silvally-Water	Water
Minior	Rock	Flying
Minior-Meteor	Rock	Flying
Komala	Normal
Turtonator	Fire	Dragon
Togedemaru	Electric	Steel
Togedemaru-Totem	Electric	Steel
Mimikyu	Ghost	Fairy
Mimikyu-Busted	Ghost	Fairy
Mimikyu-Totem	Ghost	Fairy
Mimikyu-Busted-Totem	Ghost	Fairy
Bruxish	Water	Psychic
Drampa	Normal	Dragon
Dhelmise	Ghost	Grass
Jangmo-o	Dragon
Hakamo-o	Dragon	Fighting
Kommo-o	Dragon	Fighting
Kommo-o-Totem	Dragon	Fighting
Tapu Koko	Electric	Fairy
Tapu Lele	Psychic	Fairy
Tapu Bulu	Grass	Fairy
Tapu Fini	Water	Fairy
Cosmog	Psychic
Cosmoem	Psychic
Solgaleo	Psychic	Steel
Lunala	Psychic	Ghost
Nihilego	Rock	Poison
Buzzwole	Bug	Fighting
Pheromosa	Bug	Fighting
Xurkitree	Electric
Celesteela	Steel	Flying
Kartana	Grass	Steel
Guzzlord	Dark	Dragon
Necrozma	Psychic
Necrozma-Dusk-Mane	Psychic	Steel
Necrozma-Dawn-Wings	Psychic	Ghost
Necrozma-Ultra	Psychic	Dragon
Magearna	Steel	Fairy
Magearna-Original	Steel	Fairy
Marshadow	Fighting	Ghost
Poipole	Poison
Naganadel	Poison	Dragon
Stakataka	Rock	Steel
Blacephalon	Fire	Ghost
Zeraora	Electric
Meltan	Steel
Melmetal	Steel
Melmetal-Gmax	Steel
Grookey	Grass
Thwackey	Grass
Rillaboom	Grass
Rillaboom-Gmax	Grass
Scorbunny	Fire
Raboot	Fire
Cinderace	Fire
Cinderace-Gmax	Fire
Sobble	Water
Drizzile	Water
Inteleon	Water
Inteleon-Gmax	Water
Skwovet	Normal
Greedent	Normal
Rookidee	Flying
Corvisquire	Flying
Corviknight	Flying	Steel
Corviknight-Gmax	Flying	Steel
Blipbug	Bug
Dottler	Bug	Psychic
Orbeetle	Bug	Psychic
Orbeetle-Gmax	Bug	Psychic
Nickit	Dark
Thievul	Dark
Gossifleur	Grass
Eldegoss	Grass
Wooloo	Normal
Dubwool	Normal
Chewtle	Water
Drednaw	Water	Rock
Drednaw-Gmax	Water	Rock
Yamper	Electric
Boltund	Electric
Rolycoly	Rock
Carkol	Rock	Fire
Coalossal	Rock	Fire
Coalossal-Gmax	Rock	Fire
Applin	Grass	Dragon
Flapple	Grass	Dragon
Flapple-Gmax	Grass	Dragon
Appletun	Grass	Dragon
Appletun-Gmax	Grass	Dragon
Silicobra	Ground
Sandaconda	Ground
Sandaconda-Gmax	Ground
Cramorant	Flying	Water
Cramorant-Gulping	Flying	Water
Cramorant-Gorging	Flying	Water
Arrokuda	Water
Barraskewda	Water
Toxel	Electric	Poison
Toxtricity	Electric	Poison
Toxtricity-Low-Key	Electric	Poison
Toxtricity-Gmax	Electric	Poison
Toxtricity-Low-Key-Gmax	Electric	Poison
Sizzlipede	Fire	Bug
Centiskorch	Fire	Bug
Centiskorch-Gmax	Fire	Bug
Clobbopus	Fighting
Grapploct	Fighting
Sinistea	Ghost
Sinistea-Antique	Ghost
Polteageist	Ghost
Polteageist-Antique	Ghost
Hatenna	Psychic
Hattrem	Psychic
Hatterene	Psychic	Fairy
Hatterene-Gmax	Psychic	Fairy
Impidimp	Dark	Fairy
Morgrem	Dark	Fairy
Grimmsnarl	Dark	Fairy
Grimmsnarl-Gmax	Dark	Fairy
Obstagoon	Dark	Normal
Perrserker	Steel
Cursola	Ghost
Sirfetch'd	Fighting
Mr. Rime	Ice	Psychic
Runerigus	Ground	Ghost
Milcery	Fairy
Alcremie	Fairy
Alcremie-Gmax	Fairy
Falinks	Fighting
Pincurchin	Electric
Snom	Ice	Bug
Frosmoth	Ice	Bug
Stonjourner	Rock
Eiscue	Ice
Eiscue-Noice	Ice
Indeedee	Psychic	Normal
Indeedee-F	Psychic	Normal
Morpeko	Electric	Dark
Morpeko-Hangry	Electric	Dark
Cufant	Steel
Copperajah	Steel
Copperajah-Gmax	Steel
Dracozolt	Electric	Dragon
Arctozolt	Electric	Ice
Dracovish	Water	Dragon
Arctovish	Water	Ice
Duraludon	Steel	Dragon
Duraludon-Gmax	Steel	Dragon
Dreepy	Dragon	Ghost
Drakloak	Dragon	Ghost
Dragapult	Dragon	Ghost
Zacian	Fairy
Zacian-Crowned	Fairy	Steel
Zamazenta	Fighting
Zamazenta-Crowned	Fighting	Steel
Eternatus	Poison	Dragon
Eternatus-Eternamax	Poison	Dragon
Kubfu	Fighting
Urshifu	Fighting	Dark
Urshifu-Rapid-Strike	Fighting	Water
Urshifu-Gmax	Fighting	Dark
Urshifu-Rapid-Strike-Gmax	Fighting	Water
Zarude	Dark	Grass
Zarude-Dada	Dark	Grass